{
    "tiles": [
        ["1", "1", "1", "0", "1", "1", "1"],
        ["1", "0", "0", "0", "0", "0", "1"],
        ["0", "0", "0", "0", "0", "0", "0"],
        ["0", "0", "0", "0", "0", "0", "0"],
        ["0", "0", "0", "0", "0", "0", "0"],
        ["0", "0", "0", "0", "0", "0", "0"],
        ["0", "0", "0", "0", "0", "0", "0"],
        ["0", "0", "0", "0", "0", "0", "0"]
    ],
    "stepLimit": "55",
    "targetScore": "100000"
}