{
    "tiles": [
        ["1", "0", "1", "0", "1", "0", "1"],
        ["0", "1", "0", "1", "0", "1", "0"],
        ["1", "0", "1", "0", "1", "0", "1"],
        ["0", "1", "0", "1", "0", "1", "0"],
        ["1", "0", "1", "0", "1", "0", "1"],
        ["0", "0", "0", "1", "0", "0", "0"],
        ["1", "0", "1", "0", "1", "0", "1"],
        ["0", "1", "0", "1", "0", "1", "0"],
        ["0", "1", "0", "1", "0", "1", "0"]
    ],
    "stepLimit": "0",
    "targetScore": "0"
}